ɔ	Off
ɑ	fAther
i	bEE
u	fOOd
ɛ	rEd
ɪ	wIn
ʊ	shOUld
ʌ	sUn
ə	sofA
æ	fAst
eɪ	sAY
aɪ	rIde
oʊ	shOW
aʊ	nOW
ɔɪ	bOY
p	Pay
b	Buy
t	Take
d	Day
k	Key
g	Go
tʃ	CHair
dʒ	Just
f	For
v	Very
θ	THanks
ð	THe
s	Say
z	Zoo
ʃ	SHow
ʒ	Measure
h	House
m	Man
n	No
ŋ	siNG
l	Late
ɹ	Run
ɾ	weTTer
j	Yes
w	Way
ʔ	buTTon
